0	0	0	1	0	1	0	0	0	0	0	0	0	0	0	0	2
3	0	0	1	0	0	0	0	0	3	0	0	0	0	0	0	0
0	0	0	0	0	0	0	0	0	0	0	0	0	0	0	0	1
3	0	0	0	0	0	0	0	0	0	0	0	0	0	3	0	0
0	0	0	0	0	0	0	0	0	0	3	0	0	0	0	3	0
0	0	0	7	0	0	0	0	3	0	0	3	0	0	0	0	0
0	0	3	0	0	4	0	0	0	0	0	0	3	0	0	0	0
0	0	0	3	1	0	0	0	0	0	0	0	0	0	3	0	0
0	0	0	0	0	0	0	2	0	0	0	0	0	0	0	0	0
0	0	3	0	4	0	0	3	0	3	1	0	0	0	0	0	0
0	0	0	0	0	0	0	0	0	0	0	0	0	0	0	0	2
0	0	0	0	0	1	0	0	0	0	0	0	0	3	0	0	0
0	0	3	0	0	0	0	0	0	0	0	0	0	0	0	0	0
0	0	0	0	0	0	0	0	0	0	0	3	0	0	0	0	0
0	0	0	0	0	1	2	3	0	0	0	3	0	0	0	0	0
0	1	2	2	2	8	0	9	3	0	0	0	0	0	0	0	1
0	0	0	0	0	0	0	0	5	0	0	0	0	0	0	0	8
0	0	0	0	0	0	0	0	9	2	2	2	0	0	0	0	3