0 0 0 0 0 0 0 0 0 0 0 0 0 0 0 0 0 
1 0 0 0 0 0 0 0 0 0 0 0 0 0 0 1 0 
1 0 0 0 0 0 0 0 0 0 0 0 0 0 0 2 0 
1 0 0 0 0 0 0 0 0 0 1 1 1 0 0 1 0 
1 0 0 0 0 0 0 0 0 0 0 0 0 0 0 1 0 
1 9 9 9 9 9 9 9 9 9 9 9 9 9 9 1 0 
1 0 0 1 1 1 0 0 0 0 0 0 0 0 0 1 0 
2 0 0 0 0 9 9 9 9 9 9 0 0 0 9 1 0 
1 0 0 0 0 0 0 0 0 0 0 0 0 0 0 1 0 
1 0 0 0 0 0 0 0 0 0 0 0 0 0 0 1 0 
1 9 9 9 9 9 9 9 9 1 2 2 2 2 2 2 0 
1 2 3 0 0 0 0 0 0 4 0 0 0 0 0 0 0 
4 0 5 0 0 0 0 0 0 4 0 0 0 0 0 0 0 
3 0 0 0 8 0 0 0 0 4 0 0 0 0 0 0 0 
5 0 1 2 2 2 2 2 2 6 0 0 0 0 0 0 0 
5 0 4 0 0 0 0 0 0 0 0 0 0 0 0 0 0 
5 0 4 0 0 0 0 0 0 0 0 0 0 0 0 0 0 
5 0 4 0 0 0 0 0 0 0 0 0 0 0 0 0 0 