4X
0	0	0	0	0	0	0	0	0X0	0	0	0	0	0	0	0
0	0	0	0	0	0	0	0	0	0	0	0	0	0	0	0	0
0	0	0	0	0	0	0	0	0	0	0	0	0	0	0	0	0
0	0	0	0	0	0	0	0	0	0	0	0	0	0	0	0	0
0	0	0	0	0	0	0	0	0	0	0	0	0	0	0	0	0
0	0	0	0	0	0	0	0	0	0	0	0	0	0	0	0	0
0	0	0	0	0	0	0	0	0	0	0	0	0	0	0	0	0
0	0	0	0	0	0	0	0	0	0	0	0	0	0	0	0	0
0	0	0	0	0	0	0	0	0	0	0	0	7	0	7	0	0
2	2	2	3	0	0	b	0	0	b	0	1	2	2	2	2	3
6	6	6	5	0	0	2	0	0	2	0	0	0	0	0	0	0
6	6	6	9	3	0	0	0	7	0	0	0	b	0	0	0	0
6	6	6	6	9	2	2	2	2	3	0	0	2	0	0	0	0
0	0	0	0	0	0	0	0	0	0	0	0	0	0	2	0	0
0	0	0	0	0	0	0	0	0	0	0	0	0	0	0	0	1
0	7	7	7	0	0	b	0	0	0	1	3	0	0	1	2	8
1	2	2	2	2	2	2	2	2	2	8	5	0	0	4	6	6
