0 0 0 0 0 0 0 0 0 0 0 0 0 0 0 0 0 
0 0 0 0 0 0 0 0 0 0 0 0 0 0 0 0 0 
0 0 0 0 7 0 0 0 0 0 0 0 0 0 0 0 0 
1 0 2 3 0 0 1 2 0 0 1 2 2 3 0 0 0 
0 0 2 7 1 1 2 0 0 0 0 0 0 0 0 0 0 
0 0 1 0 0 0 2 0 0 0 0 0 0 0 0 0 0 
0 0 0 1 0 2 5 0 0 0 2 7 1 0 0 0 0 
0 0 0 0 0 1 0 3 0 0 0 0 0 0 0 0 0 
0 0 0 0 0 0 0 0 0 0 0 0 0 0 0 0 0 
0 0 0 0 0 4 0 0 0 0 1 1 2 0 0 0 0 
0 0 0 0 0 0 0 0 0 1 2 2 2 2 2 2 0 
1 2 3 0 0 0 0 0 0 4 0 0 0 0 0 0 0 
4 6 5 0 1 0 0 0 0 4 0 0 0 0 0 0 0 
3 0 0 0 0 0 0 0 0 4 0 0 0 0 0 0 0 
5 0 1 2 2 2 2 2 2 8 0 0 0 0 0 0 0 
5 0 4 0 0 0 0 0 0 0 0 0 0 0 0 0 0 
5 0 4 0 0 0 0 0 0 0 0 0 0 0 0 0 0 
5 0 4 0 0 0 0 0 0 0 0 0 0 0 0 0 0 